[console_scripts]
add-date-created = encoded.commands.add_date_created:main
add-image-tag = dcicutils.ecr_scripts:add_image_tag_main
batchupgrade = snovault.batchupgrade:main
check-rendering = encoded.commands.check_rendering:main
clear-db-es-contents = snovault.commands.clear_db_es_contents:main
configure-kibana-index = encoded.commands.configure_kibana_index:main
create-mapping = snovault.elasticsearch.create_mapping:main
create-mapping-on-deploy = snovault.commands.create_mapping_on_deploy:main
dev-servers = snovault.dev_servers:main
dis2pheno = encoded.commands.parse_hpoa:main
es-index-data = snovault.commands.es_index_data:main
export-data = encoded.commands.export_data:main
extract-test-data = encoded.commands.extract_test_data:main
flatten-structured-data = encoded.commands.flatten_structured_data:main
generate-local-access-key = snovault.commands.generate_local_access_key:main
import-data = encoded.commands.import_data:main
ingestion-listener = snovault.ingestion.ingestion_listener:main
jsonld-rdf = encoded.commands.jsonld_rdf:main
load-access-keys = snovault.commands.load_access_keys:main
load-data = snovault.commands.load_data:main
load-data-by-type = snovault.commands.load_data_by_type:main
load-items = encoded.commands.load_items:main
make-submission-access-key = encoded.commands.make_submission_access_key:main
migrate-attachments-aws = encoded.commands.migrate_attachments_aws:main
migrate-dataset-type = encoded.commands.migrate_dataset_type:main
migrate-files-aws = encoded.commands.migrate_files_aws:main
order-schema-columns-and-facets = encoded.commands.order_schema_columns_and_facets:main
owl-to-items = encoded.commands.generate_items_from_owl:main
parse-structured-data = encoded.commands.parse_structured_data:main
prepare-docker = encoded.commands.prepare_template:prepare_docker_main
prepare-local-dev = encoded.commands.prepare_template:prepare_local_dev_main
profiler = encoded.commands.profiler:main
publish-to-pypi = dcicutils.scripts.publish_to_pypi:main
purge-item-type = encoded.commands.purge_item_type:main
run-upgrade-on-inserts = encoded.commands.run_upgrader_on_inserts:main
show-global-env-bucket = dcicutils.env_scripts:show_global_env_bucket_main
show-image-catalog = dcicutils.ecr_scripts:show_image_catalog_main
show-image-manifest = dcicutils.ecr_scripts:show_image_manifest_main
show-schema = encoded.commands.show_schema:main
simulate-environment = encoded.commands.simulate_environment:main
spreadsheet-to-json = encoded.commands.spreadsheet_to_json:main
submission-test = encoded.commands.submission_test:main
unrelease-most-recent-image = dcicutils.ecr_scripts:unrelease_most_recent_image_main
update-inserts-from-server = encoded.commands.update_inserts_from_server:main
verify-item = encoded.commands.verify_item:main
view-local-object = snovault.commands.view_local_object:main
wipe-test-indices = snovault.commands.wipe_test_indices:main

[paste.app_factory]
main = encoded:main

[paste.composite_factory]
indexer = snovault.elasticsearch.es_index_listener:composite
ingester = snovault.ingestion.ingestion_listener:composite

[paste.filter_app_factory]
memlimit = snovault.memlimit:filter_app
